**************************************
*                                    *
*                                    *
*                                    *
*                                    *
*                                    *
*                                    *
*                                    *
*                                    *
*                                    *
*                                    *
*                                    *
*                                    *
*         oo                         *
*              -    -                *
*                                    *
*         **                         *
*        ****                        *
*oo   h ******                 !     *
**********************************   *